1111111111
1400000001
1000000001
1000000001
1000000001
1000000001
1000000001
1000000001
1000000031
1111111111