1111111111
1000000001
1000000301
1201000001
1000000001
1000000001
1000002201
1003300001
1000000001
1111111111