1111111111
1400000001
1000000001
1000000001
1000000021
1000000001
1000000001
1000000001
1020000031
1111111111